N E N N N N N N N
X N N E E E N N X
X N E N N N N N X
N N N E E E N N X
X X X X X X X X X