N E N N N N N N N N N
X N N E E E N N X N N
X N E N N N N N X E E
N N N E E E N N X E E
N E N N E E N N N N X
N N E N E X N E X X X
X X X X X X X X X X X